%%%%%%#%%%%%%%%%%%%%%%%%%%%%%%%%%%%%%%%%%%
%+++++++++++%+++++%-------%.....%........%
%+%%%%%%%%%+%+%%%%%-%.%%%-%%%%%.%.%%%%%%%%
%+%+%++++%%+#+++++%-%.%..----F...........%
%+%+%+%%%%%+%+%%%+%-%.%.%%%%%%%%%.%%%%%%.%
%+%+%+%%%+++%+%+%+%-%.%................%.%
%+%+%+%+%+%+%+%+++%-%.%%%%%%%%%%#.%%%%%%.%
%+%+%+%+%+%+%+%%%%%-%...........%......%.%
%+%+%+%+%+%+%++++++-%.%%%%%%%%%%%%%%%%.%.%
%%%+%+%+%%%+%%%%%%%-%.%................%.%
%+++++++++++++++++%-%.%.%%%%#%%%%%%%%%.%.%
%%%%%%%+%%%+#%%%%%%-%.%.%............%.%.%
%+%+++++++%+%+++++%-%.%.%.%%%%%%%%%%.%.%.%
%+%%%%%+%+%+%+%%%+%-%.%.%.%........%.%.%.%
%+%+++++%+%+%+%+++%-%.%.%.%.%%%%%%.%.%.%.%
%+%%%%%%%+%+%+%%%%%-%.%.%.%.%....%.%...%.%
%+++++++%+%+%++++++-%.%%%.%.%.%%%%.%%%%%.%
%+%%%%%%%+%+%%%%%%%-%.%...%.%..........%.%
%+++++++++%+++++++%-%.%.%%%.%%%%%%%%%%%%.%
%%%%%%%%%%%+%%%%%%%-%.%.%................%
%-----------------%-%.%.%%%%%%%%%%%%%%%%%%
%-%%%%%%%%%%%%%%%-%-%.%.%............%...%
%-%-------------%-%-%.%.%.%%%%%%%%%%.%.%.%
%-%-%%%%%%%%%%%-%-%-%.%.%.%........%.#.%.%
%-%-%-----------%-%-%.%.%.%.%%%%%%.%.%.%.%
%-%-%-%%%%%%%%%.%-%-%.%.%.%.%......%.%.%.%
%-%-%-%.........%-%-%.%.%.%.%.%%%%.%.%.%.%
%-%-%-%%%%%%#%%%%-%-%.#.%.%.%.%....%.%.%.%
%-%-%-------------%-%.%.%.%.#.%%%%%%.%.%.%
%-%-%%%%%%%%%%%%%%%-%.%.%.%.%........%.%.%
%-%-----------------%.%.%%%.%%%%%%%%%%.%.%
%-%.%%%%%%%%%%%%%%%%%.%.%.....%........%.#
%-%.%.......%.%.%.%.%.%.%.%%%.%.%.%%%%%%.%
%-%.%.%%%%%.%.%.%.%.%.%.%.%.%.%.%....%.%.%
%-%.%.%...%.%.%.%.%.%.%.%.%.%.%.%.%%.%.%.%
%-%.%.%.%.%.%.%.%.%.%.%.%.%.%.%.%.%..%.%.%
%-%.%.%.%.%.%.%.%.%.%.%.%.%.%.%.%.%%%%.%.%
%-%.%.%.%%%.%.%.%.%.%.%.%...%.%.%......%.%
%-%.%.%.............%.%.%%%%#.%.%%%%%%%%.%
%-%.%.%%%%%%%%%%%%%%%.%................%.%
%-%.%...%...%...%...%.%%%%%%%%%%%%%%%%%%.%
%-%.%.%...%...%...%.%....................%
%-%.%%%%%%%%%%%%%%%.%%%%%%%%%%%%%%%%%%%%%%
--.......................................%
%%%%%%%%%%%%%%%%%%%%%%%%%%%%%%%%%%%%%%%%%%
