##%%%%#%#-##
#+++#-----+#
#+%+%-%%#%+%
%%#+#----%+%
#++++%#%-#+#
%%#%+%F%-%+#
%++#+%-#-%+#
%%+#+%-%-#+#
#+++++---%+%
%%%#%%+%##+#
#++++++%+++%
%###%%%##%##
