%##%%%%%#%%#
#....------#
%.%.%-#%%%-%
%%%.%----%-%
#....#%%-%-#
%%%%.%F--%-%
%##%%%%#%%-%
