%%%-%%%%%%%%
%.+--------%
%+%%%%%%%%-%
%+#......%-%
%+%.%%%%.%-%
%+%..%F%.%-%
%+%.%--%.%-%
%+%%%-%..%-%
%-----..%%-%
%-%%%%%%%--%
%---------%%
%%%%#%%%%%%%
