%%%%%%#%#%%%
#+++#------%
#+%+%-%%%#-%
%%%+%----%-%
%++++%#%-#-#
##%%+#F%-%-#
%++%+%-%-%-#
%#+%+%-%-%-%
%+++++---%-%
#%%%%%+%%%-#
#++++++%---%
%#%%%%%%-%%%
