%%%%%%%%%%%%%%%%%%%%
#---%......%....%..%
--%-%.%%%%.%.%%%.%.%
%%%-%....%.%.%...%.%
%..--%%%.%.%.%.%%%.%
%%%%-%F%.%.%...%...%
%..%-%-%.%.%%%.%.%%%
%%.%-%-%.%.%...%.%.%
%...---..%.%.%%%.%.%
%%%%%%.%%%.%.%.....%
%......%...%.%%.%%%#
%.%%%%%%.%%%..%.%..%
%.%....%....%.%.%.%%
%.%.%%.%.%%...%....%
%.%.%....%..%%%%%%.%
%.%.%.%%.%.%.......%
%.%%%...%..%.%.%.%%%
%...%%%%%.%%.%.%.%.%
%.%...%......%.%...%
%.%%%.%.%%%%%%%%%.%%
%.%.%.%%...%....%%%%
%...%....%.%.%.%...%
%.%.%.%%%%.%.#.%.%.%
%#%.%....%.%.%...%.%
%....%%%.%.%.%.%%%.%
%%%%.%.%.%.%...%...%
%..%.%.%.%.%%%.%.%%%
%%.%.%.%.%.%...%.%.%
%......%.%.%.%%%.%.%
%%%%%%.%%%.%.%.....%
%......%...%.%%.%%%%
%.%%%%%%.%%%..%.%..%
%.#....%....%.%.%.%%
%.%.%%.%.%%...%....%
%.%.%....%..%%%%%%.%
%.%.%.%%.%.%.......%
%.%%%...%..%.%.%.%%%
%...%%%%%.%%.%.%.%.%
%.%...%......%.%...%
%%%%%%%%%%%%%%%%%%%%
